# Map file for tile-based game 
# (Lines that start with '#' are comments)
# The tiles are:
#   (Space) Empty tile
#   A..Z    Tiles A through Z
#   o       Star
#   !       Music Note
#   *       Goal
#   1       Bad Guy 1 (grub)
#   2       Bad Guy 2 (fly)
BF          o o o                o o o o o o o o o o o o o o o o o o o o o o o                EB
AD         IIIIIII              IIIIIIIIIIIIIIIIIIIIIIIIIIIIIIIIIIIIIIIIIIIIIII               CA
AD              E       o o o          E     I                   EBBBBBBBBBBBBBF     o o o o  CA
AD              E      IIIIIII         E     I                   CAAAAAAAAAAAAAD    o o o o o CA
AD              E                      E     I             o o   CAAAAAAAAAAAAAHF    o o o o  CA
AD              E     2   !        2   E                  IIIII  CAAAAAAAAAAAAAAD   o o o o o CA
AD              E       IIIII          E                         CAAAAAAAAAAAAAAHF   IIIIIII  CA
AD         III  E                       1    1  1        2       CAAAAAAAAAAAAAAAD  o o o o o CA
AD                            1      IIIIIIIIIIIII               CAAAAAAAAAAAAAAAHF  o o o o  CA
AD      1       EBBBBBBBBBBBBBBBF     o o o o o o              * CAAAAAAAAAAAAAAAAD o o o o o CA
AHBBBBBBBBBBBBBBGAAAAAAAAAAAAAAAHBBBBBBBBBBBBBBBBBBBBBBBBBBBBBBBBGAAAAAAAAAAAAAAAAHBBBBBBBBBBBGA