# Map file for tile-based game
# (Lines that start with '#' are comments)
# The tiles are:
#   (Space) Empty tile
#   A..Z    Tiles A through Z
#   o       Star
#   !       Music Note
#   *       Goal
#   1       Bad Guy 1 (grub)
#   2       Bad Guy 2 (fly)
BF          o o o                o o o o o o o o o o o o o o o o o o o o o o oI
BF          o o o                o o o o o o o o o o o o o o o o o o o o o o oI
AD         IIIIIII              IIIIIIIIIIIIIIIIIIIIIIIIIIIIIIIIIIIIIIIIIIIIIII
AD                      o o o                                    EBBBBBBBBBBBBI
AD                     IIIIIII                                   CAAAAAAAAAAAAI
AD                                                         o o   CAAAAAAAAAAAAI
AD                    2   !        2                      IIIII  CAAAAAAAAAAAAI
AD                      IIIII                                                 I
AD                      2               1    1  1        2                    I
AD   I  1  I  1  2   o o o o o o              * CAAAAAAAAAAAAAAAAD o o o o o CI
AHBBBBBBBBBBBBBBGAAAAAAAAAAAAAAAHBBBBBBBBBBBBBBBBBBBBBBBBBBBBBBBBGAAAAAAAAAAAAI